image/otherMap.png
noparallax nooverlayer
1
1 32 128
10 6
1 1 0 0 0 0 0 0 0 0 0 0 0 0 0 0 0 0 0 0
1 1 0 0 0 0 0 0 0 0 0 0 0 0 0 0 0 0 0 0
1 1 0 0 0 0 0 0 0 0 0 0 0 0 0 0 0 0 0 0
1 1 0 0 0 0 0 0 0 0 0 0 0 0 0 0 0 0 0 0
1 1 3 3 0 0 0 0 0 0 0 0 0 0 0 0 0 0 0 0
1 1 3 3 0 0 0 0 0 0 0 0 0 0 0 0 0 0 0 0
1 1 1 1 1 1 1 1 1 1 1 1 1 1 1 1 2 2 0 0
1 1 0 0 0 0 0 0 0 0 0 0 0 0 0 0 2 2 0 0
1 1 0 0 0 0 0 0 0 0 0 0 0 0 0 0 2 2 0 0
1 1 0 0 0 0 0 0 0 0 0 0 0 0 0 0 2 2 0 0
1 1 1 1 1 1 1 1 1 1 1 1 1 1 1 1 1 1 1 1
0 0 0 0 0 0 0 0 0 0 0 0 0 0 0 0 0 0 0 0
0 255 96